XXXXXXXXXXXXXXXXXXXXXXX
X                     X
X  XXXXXXXXXXXXXX     X
X                     X
X     X           X   X
X     X           X   X
X  2  X           X   X
X     I    X      X   X
X     I        a      X
X     I    X          X
X  2  X               X
X     X     IIIII     X
X     X     I         X
X           I         X
X           I      1  X
X                     X
XXXXXXXXXXXXXXXXXXXXXXX